1111111111111
100100000W0C1
1000011111001
1P0011E0C0001
1111111111111