1111111111
10EC0001C1
1C001000C1
1P00C10001
1111111111